xxxxxxxxxxxxxxxxxxxxxxxxxxxxxxxx
x                              x
x                              x
x                              x
x                              x
x                              x
x                              x
x                d             x
x             xxxxx            x
x       xxx                    x
x     xxx                      x
x          xxx                 x
x               xxx            x
x                              x
x                xxx           x
x                      xxx     x
x d         @                  x
xxxxxxxxxxxxxxxxxxxxxxxxxxxxxxxx